To : 890078-close@bugs.debian.org
Subject : Bug#890078: fixed in tasksel 3.43
From : Christian Perrier <bubulle@debian.org>
Date : Sun, 11 Feb 2018 07:34:32 +0000
Message-id : m9g-000CIg-9A@fasolo.debian.org
Reply-to : 890078@bugs.debian.org
References : <E1ekm9g-000CIg-9A@fasolo.debian.org> <[ðŸ”Ž]Â 20180210221634.cb715c7c69264f1979529620@wansing-online.de>


Your message dated Sun, 11 Feb 2018 07:34:32 +0000
with message-id <E1ekm9g-000CIg-9A@fasolo.debian.org>
and subject line Bug#890078: fixed in tasksel 3.43
has caused the Debian Bug report #890078,
regarding tasksel: initial translation of templates into Tajik
to be marked as done.
This means that you claim that the problem has been dealt with.
If this is not the case it is now your responsibility to reopen the
Bug report if necessary, and/or fix the problem forthwith.
(NB: If you are a system administrator and have no idea what this
message is talking about, this may indicate a serious mail system
misconfiguration somewhere. Please contact owner@bugs.debian.org
immediately.)
-- 
890078: https://bugs.debian.org/cgi-bin/bugreport.cgi?bug=890078
Debian Bug Tracking System
Contact owner@bugs.debian.org with problems
tasksel_debian_tg.potasksel_tasks_tg.poSource: tasksel
Source-Version: 3.43
We believe that the bug you reported is fixed in the latest version of
tasksel, which is due to be installed in the Debian FTP archive.
A summary of the changes between this version and the previous one is
attached.
Thank you for reporting the bug, which will now be closed.  If you
have further comments please address them to 890078@bugs.debian.org,
and the maintainer will reopen the bug report if appropriate.
Debian distribution maintenance software
pp.
Christian Perrier <bubulle@debian.org> (supplier of updated tasksel package)
(This message was generated automatically at their request; if you
believe that there is a problem with it please contact the archive
administrators by mailing ftpmaster@ftp-master.debian.org)
-----BEGIN PGP SIGNED MESSAGE-----
Hash: SHA256
Format: 1.8
Date: Sun, 11 Feb 2018 08:14:31 +0100
Source: tasksel
Binary: tasksel tasksel-data task-desktop task-gnome-desktop task-kde-desktop task-lxde-desktop task-lxqt-desktop task-xfce-desktop task-cinnamon-desktop task-mate-desktop task-laptop task-web-server task-print-server task-ssh-server task-albanian-desktop task-amharic task-amharic-desktop task-amharic-kde-desktop task-arabic task-arabic-desktop task-arabic-kde-desktop task-asturian task-asturian-desktop task-basque task-basque-desktop task-basque-kde-desktop task-belarusian task-belarusian-desktop task-belarusian-kde-desktop task-bengali task-bengali-desktop task-bengali-kde-desktop task-bosnian task-bosnian-desktop task-bosnian-kde-desktop task-brazilian-portuguese task-brazilian-portuguese-desktop task-brazilian-portuguese-kde-desktop task-british-desktop task-british-kde-desktop task-bulgarian task-bulgarian-desktop task-bulgarian-kde-desktop task-catalan task-catalan-desktop task-catalan-kde-desktop task-chinese-s task-chinese-s-desktop task-chinese-s-kde-desktop
 task-chinese-t task-chinese-t-desktop task-chinese-t-kde-desktop task-croatian task-croatian-desktop task-croatian-kde-desktop task-czech task-czech-desktop task-czech-kde-desktop task-danish task-danish-desktop task-danish-kde-desktop task-dutch task-dutch-desktop task-dutch-kde-desktop task-dzongkha-desktop task-dzongkha-kde-desktop task-english task-esperanto task-esperanto-desktop task-esperanto-kde-desktop task-estonian task-estonian-desktop task-estonian-kde-desktop task-finnish task-finnish-desktop task-finnish-kde-desktop task-french task-french-desktop task-french-kde-desktop task-galician task-galician-desktop task-galician-kde-desktop task-georgian-desktop task-german task-german-desktop task-german-kde-desktop task-greek task-greek-desktop task-greek-kde-desktop task-gujarati task-gujarati-desktop task-gujarati-kde-desktop task-hebrew task-hebrew-desktop task-hebrew-gnome-desktop task-hebrew-kde-desktop task-hindi task-hindi-desktop
 task-hindi-kde-desktop task-hungarian task-hungarian-desktop task-hungarian-kde-desktop task-icelandic task-icelandic-desktop task-icelandic-kde-desktop task-indonesian-desktop task-indonesian-kde-desktop task-irish task-irish-desktop task-irish-kde-desktop task-italian task-italian-desktop task-italian-kde-desktop task-japanese task-japanese-desktop task-japanese-gnome-desktop task-japanese-kde-desktop task-kannada-desktop task-kannada-kde-desktop task-kazakh task-kazakh-desktop task-kazakh-kde-desktop task-khmer task-khmer-desktop task-khmer-kde-desktop task-korean task-korean-desktop task-korean-gnome-desktop task-korean-kde-desktop task-kurdish task-kurdish-desktop task-kurdish-kde-desktop task-latvian task-latvian-desktop task-latvian-kde-desktop task-lithuanian task-lithuanian-desktop task-lithuanian-kde-desktop task-macedonian task-macedonian-desktop task-macedonian-kde-desktop task-malayalam task-malayalam-desktop task-malayalam-gnome-desktop
 task-malayalam-kde-desktop task-marathi task-marathi-desktop task-nepali-desktop task-nepali-kde-desktop task-northern-sami task-northern-sami-desktop task-norwegian task-norwegian-desktop task-norwegian-kde-desktop task-persian task-persian-desktop task-persian-kde-desktop task-polish task-polish-desktop task-polish-kde-desktop task-portuguese task-portuguese-desktop task-portuguese-kde-desktop task-punjabi task-punjabi-desktop task-punjabi-kde-desktop task-romanian task-romanian-desktop task-romanian-kde-desktop task-russian task-russian-desktop task-russian-kde-desktop task-serbian task-serbian-desktop task-serbian-kde-desktop task-sinhala-desktop task-sinhala-kde-desktop task-slovak task-slovak-desktop task-slovak-kde-desktop task-slovenian task-slovenian-desktop task-slovenian-kde-desktop task-south-african-english-desktop task-spanish task-spanish-desktop task-spanish-kde-desktop task-swedish task-swedish-desktop task-swedish-kde-desktop task-tagalog
 task-tamil task-tamil-desktop task-tamil-gnome-desktop task-telugu task-telugu-desktop task-telugu-gnome-desktop task-telugu-kde-desktop task-thai task-thai-desktop task-thai-gnome-desktop task-thai-kde-desktop task-turkish task-turkish-desktop task-turkish-kde-desktop task-ukrainian task-ukrainian-desktop task-ukrainian-kde-desktop task-uyghur-desktop task-uyghur-kde-desktop task-vietnamese-desktop task-vietnamese-kde-desktop task-welsh task-welsh-desktop task-xhosa-desktop task-xhosa-kde-desktop task-cyrillic task-cyrillic-desktop
 task-cyrillic-kde-desktop
Architecture: source
Version: 3.43
Distribution: unstable
Urgency: medium
Maintainer: Debian Install System Team <debian-boot@lists.debian.org>
Changed-By: Christian Perrier <bubulle@debian.org>
Description:
 task-albanian-desktop - Albanian desktop
 task-amharic - Amharic environment
 task-amharic-desktop - Amharic desktop
 task-amharic-kde-desktop - Amharic KDE desktop
 task-arabic - Arabic environment
 task-arabic-desktop - Arabic desktop
 task-arabic-kde-desktop - Arabic KDE desktop
 task-asturian - Asturian environment
 task-asturian-desktop - Asturian desktop
 task-basque - Basque environment
 task-basque-desktop - Basque desktop
 task-basque-kde-desktop - Basque KDE desktop
 task-belarusian - Belarusian environment
 task-belarusian-desktop - Belarusian desktop
 task-belarusian-kde-desktop - Belarusian KDE desktop
 task-bengali - Bengali environment
 task-bengali-desktop - Bengali desktop
 task-bengali-kde-desktop - Bengali KDE desktop
 task-bosnian - Bosnian environment
 task-bosnian-desktop - Bosnian desktop
 task-bosnian-kde-desktop - Bosnian KDE desktop
 task-brazilian-portuguese - Brazilian Portuguese environment
 task-brazilian-portuguese-desktop - Brazilian Portuguese desktop
 task-brazilian-portuguese-kde-desktop - Brazilian Portuguese KDE desktop
 task-british-desktop - British English desktop
 task-british-kde-desktop - British KDE desktop
 task-bulgarian - Bulgarian environment
 task-bulgarian-desktop - Bulgarian desktop
 task-bulgarian-kde-desktop - Bulgarian KDE desktop
 task-catalan - Catalan environment
 task-catalan-desktop - Catalan desktop
 task-catalan-kde-desktop - Catalan KDE desktop
 task-chinese-s - Simplified Chinese environment
 task-chinese-s-desktop - Simplified Chinese desktop
 task-chinese-s-kde-desktop - Simplified Chinese KDE desktop
 task-chinese-t - Traditional Chinese environment
 task-chinese-t-desktop - Traditional Chinese desktop
 task-chinese-t-kde-desktop - Traditional Chinese KDE desktop
 task-cinnamon-desktop - Cinnamon
 task-croatian - Croatian environment
 task-croatian-desktop - Croatian desktop
 task-croatian-kde-desktop - Croatian KDE desktop
 task-cyrillic - Cyrillic environment
 task-cyrillic-desktop - Cyrillic desktop
 task-cyrillic-kde-desktop - Cyrillic KDE desktop
 task-czech - Czech environment
 task-czech-desktop - Czech desktop
 task-czech-kde-desktop - Czech KDE desktop
 task-danish - Danish environment
 task-danish-desktop - Danish desktop
 task-danish-kde-desktop - Danish KDE desktop
 task-desktop - Debian desktop environment
 task-dutch - Dutch environment
 task-dutch-desktop - Dutch desktop
 task-dutch-kde-desktop - Dutch KDE desktop
 task-dzongkha-desktop - Dzongkha desktop
 task-dzongkha-kde-desktop - Dzongkha KDE desktop
 task-english - General English environment
 task-esperanto - Esperanto environment
 task-esperanto-desktop - Esperanto desktop
 task-esperanto-kde-desktop - Esperanto KDE desktop
 task-estonian - Estonian environment
 task-estonian-desktop - Estonian desktop
 task-estonian-kde-desktop - Estonian KDE desktop
 task-finnish - Finnish environment
 task-finnish-desktop - Finnish desktop
 task-finnish-kde-desktop - Finnish KDE desktop
 task-french - French environment
 task-french-desktop - French desktop
 task-french-kde-desktop - French KDE desktop
 task-galician - Galician environment
 task-galician-desktop - Galician desktop
 task-galician-kde-desktop - Galician KDE desktop
 task-georgian-desktop - Georgian desktop
 task-german - German environment
 task-german-desktop - German desktop
 task-german-kde-desktop - German KDE desktop
 task-gnome-desktop - GNOME
 task-greek - Greek environment
 task-greek-desktop - Greek desktop
 task-greek-kde-desktop - Greek KDE desktop
 task-gujarati - Gujarati environment
 task-gujarati-desktop - Gujarati desktop
 task-gujarati-kde-desktop - Gujarati KDE desktop
 task-hebrew - Hebrew environment
 task-hebrew-desktop - Hebrew desktop
 task-hebrew-gnome-desktop - Hebrew GNOME desktop
 task-hebrew-kde-desktop - Hebrew KDE desktop
 task-hindi - Hindi environment
 task-hindi-desktop - Hindi desktop
 task-hindi-kde-desktop - Hindi KDE desktop
 task-hungarian - Hungarian environment
 task-hungarian-desktop - Hungarian desktop
 task-hungarian-kde-desktop - Hungarian KDE desktop
 task-icelandic - Icelandic environment
 task-icelandic-desktop - Icelandic desktop
 task-icelandic-kde-desktop - Icelandic KDE desktop
 task-indonesian-desktop - Indonesian desktop
 task-indonesian-kde-desktop - Indonesian KDE desktop
 task-irish - Irish environment
 task-irish-desktop - Irish desktop
 task-irish-kde-desktop - Irish KDE desktop
 task-italian - Italian environment
 task-italian-desktop - Italian desktop
 task-italian-kde-desktop - Italian KDE desktop
 task-japanese - Japanese environment
 task-japanese-desktop - Japanese desktop
 task-japanese-gnome-desktop - Japanese GNOME desktop
 task-japanese-kde-desktop - Japanese KDE desktop
 task-kannada-desktop - Kannada desktop
 task-kannada-kde-desktop - Kannada KDE desktop
 task-kazakh - Kazakh environment
 task-kazakh-desktop - Kazakh desktop
 task-kazakh-kde-desktop - Kazakh KDE desktop
 task-kde-desktop - KDE
 task-khmer - Khmer environment
 task-khmer-desktop - Khmer desktop
 task-khmer-kde-desktop - Khmer KDE desktop
 task-korean - Korean environment
 task-korean-desktop - Korean desktop
 task-korean-gnome-desktop - Korean GNOME desktop
 task-korean-kde-desktop - Korean KDE desktop
 task-kurdish - Kurdish environment
 task-kurdish-desktop - Kurdish desktop
 task-kurdish-kde-desktop - Kurdish KDE desktop
 task-laptop - laptop
 task-latvian - Latvian environment
 task-latvian-desktop - Latvian desktop
 task-latvian-kde-desktop - Latvian KDE desktop
 task-lithuanian - Lithuanian environment
 task-lithuanian-desktop - Lithuanian desktop
 task-lithuanian-kde-desktop - Lithuanian KDE desktop
 task-lxde-desktop - LXDE
 task-lxqt-desktop - LXQt
 task-macedonian - Macedonian environment
 task-macedonian-desktop - Macedonian desktop
 task-macedonian-kde-desktop - Macedonian KDE desktop
 task-malayalam - Malayalam environment
 task-malayalam-desktop - Malayalam desktop
 task-malayalam-gnome-desktop - Malayalam GNOME desktop
 task-malayalam-kde-desktop - Malayalam KDE desktop
 task-marathi - Marathi environment
 task-marathi-desktop - Marathi desktop
 task-mate-desktop - MATE
 task-nepali-desktop - Nepali desktop
 task-nepali-kde-desktop - Nepali KDE desktop
 task-northern-sami - Northern Sami environment
 task-northern-sami-desktop - Northern Sami desktop
 task-norwegian - Norwegian (Bokmaal and Nynorsk) environment
 task-norwegian-desktop - Norwegian (Bokmaal and Nynorsk) desktop
 task-norwegian-kde-desktop - Norwegian KDE desktop
 task-persian - Persian environment
 task-persian-desktop - Persian desktop
 task-persian-kde-desktop - Persian KDE desktop
 task-polish - Polish environment
 task-polish-desktop - Polish desktop
 task-polish-kde-desktop - Polish KDE desktop
 task-portuguese - Portuguese environment
 task-portuguese-desktop - Portuguese desktop
 task-portuguese-kde-desktop - Portuguese KDE desktop
 task-print-server - print server
 task-punjabi - Punjabi environment
 task-punjabi-desktop - Punjabi desktop
 task-punjabi-kde-desktop - Punjabi KDE desktop
 task-romanian - Romanian environment
 task-romanian-desktop - Romanian desktop
 task-romanian-kde-desktop - Romanian KDE desktop
 task-russian - Russian environment
 task-russian-desktop - Russian desktop
 task-russian-kde-desktop - Russian KDE desktop
 task-serbian - Serbian environment
 task-serbian-desktop - Serbian desktop
 task-serbian-kde-desktop - Serbian KDE desktop
 task-sinhala-desktop - Sinhala desktop
 task-sinhala-kde-desktop - Sinhala KDE desktop
 task-slovak - Slovak environment
 task-slovak-desktop - Slovak desktop
 task-slovak-kde-desktop - Slovak KDE desktop
 task-slovenian - Slovenian environment
 task-slovenian-desktop - Slovenian desktop
 task-slovenian-kde-desktop - Slovenian KDE desktop
 task-south-african-english-desktop - South African English desktop
 task-spanish - Spanish environment
 task-spanish-desktop - Spanish desktop
 task-spanish-kde-desktop - Spanish KDE desktop
 task-ssh-server - SSH server
 task-swedish - Swedish environment
 task-swedish-desktop - Swedish desktop
 task-swedish-kde-desktop - Swedish KDE desktop
 task-tagalog - Tagalog environment
 task-tamil - Tamil environment
 task-tamil-desktop - Tamil desktop
 task-tamil-gnome-desktop - Tamil GNOME desktop
 task-telugu - Telugu environment
 task-telugu-desktop - Telugu desktop
 task-telugu-gnome-desktop - Telugu GNOME desktop environment
 task-telugu-kde-desktop - Telugu KDE desktop environment
 task-thai  - Thai environment
 task-thai-desktop - Thai desktop
 task-thai-gnome-desktop - Thai GNOME desktop
 task-thai-kde-desktop - Thai KDE desktop
 task-turkish - Turkish environment
 task-turkish-desktop - Turkish desktop
 task-turkish-kde-desktop - Turkish KDE desktop
 task-ukrainian - Ukrainian environment
 task-ukrainian-desktop - Ukrainian desktop
 task-ukrainian-kde-desktop - Ukrainian KDE desktop
 task-uyghur-desktop - Uyghur desktop
 task-uyghur-kde-desktop - Uyghur KDE desktop
 task-vietnamese-desktop - Vietnamese desktop
 task-vietnamese-kde-desktop - Vietnamese KDE desktop
 task-web-server - web server
 task-welsh - Welsh environment
 task-welsh-desktop - Welsh desktop
 task-xfce-desktop - Xfce
 task-xhosa-desktop - Xhosa desktop
 task-xhosa-kde-desktop - Xhosa KDE desktop
 tasksel    - tool for selecting tasks for installation on Debian systems
 tasksel-data - official tasks used for installation of Debian systems
Closes: 878483 885142 890078
Changes:
 tasksel (3.43) unstable; urgency=medium
 .
   [ Christian Perrier ]
   * Replace gnome-orca transitional package by orca
     Thanks to Jeremy Bicha. Closes: #885142
   * Drop Drop extra Recommends in task-gnome-desktop
     Thanks to Jeremy Bicha. Closes: #878483
 .
   [ Translations ]
   * Added Tajik translations of programs ans tasks
     Thanks to Victor Ibragimov
     Closes: #890078
Checksums-Sha1:
 34eb043ac4a2c7de489ce8dfca624c62c28e7c74 17021 tasksel_3.43.dsc
 12024e18a255b5aebfdbd2bea14d9222fa477471 19057675 tasksel_3.43.tar.gz
Checksums-Sha256:
 6d6c3934057cd02f905fd18861e24b04f12431ba365900a596d44900ef592d31 17021 tasksel_3.43.dsc
 a69530fca7d0526161fadb9cd3c621701af33ba773bb3e21aed3d27ade5e2d79 19057675 tasksel_3.43.tar.gz
Files:
 6ea6e5f1c36525ac8c6cc41151fec1f0 17021 tasks optional tasksel_3.43.dsc
 e5c07cb2297adcdbe20565e8bbdd7331 19057675 tasks optional tasksel_3.43.tar.gz
-----BEGIN PGP SIGNATURE-----
iQIzBAEBCAAdFiEE1cL5v8oSi7oip3IYhy9wLE1uJagFAlp/7+YACgkQhy9wLE1u
Jagw5hAAskPh2U98Y7YPVgh7+nZ7Dp28m2Om1AwooXPAJU+1JEbRwcyDgM9II01R
lD1BW1m+z8K1XE5L3Ts5GNNEoeckjr3LHzwSIi+s+OCm/xs7ivJ+hLieNRiuIrfu
Vis+oV0abzKu/6FUwNr35uzLaH6hF4S5YXMKZPtmmS7cx1TvnpncvGQmjW6mazcT
JA4MKAkzMFA/T5JZm15jQ5GiThtLlG+UWjv2Wd4kHfLG6UIGBNj+CcfWTBlgehnF
DcQjEBFVyLoovl5hBVYYxXqd8KWGHXxNH3g/NPWnUYb3pBriqYdsYGrUJlujk0MM
aMwhienanEJ1r+zzTXKk1JVSdjT8iILNV0UOOTofQ1MJRYunWqRfCrHuXhC5TAd9
0UvNWQxNI02J5XaGcARQqEx30b2QwUeJgoGe0bgg6Zzc0WUlhfe1GZcHcxCwNJKw
WWuAi+0/Qqxz/XOaN2hyLtDLTrd1Woy2KsG+glTt83p+BSqGl7LRsjYN+dlO0r7a
vLhb4z2hK+3NC8RjhIITEXKFGnek9U0jtTWqzpYMhMEJXFBX8Y7fb7dGSwjrtGDF
EusPuf6Ii9op+hP5lpjEnR/cSenlTtu4rJJp4sgktDxtFOtOvQ+iRau3wNJwJjMc
STkqQUSDNsmUdzC51N8InliJgXKtN363gJSeFMEItIKOCCNM7xE=
=lAY+
-----END PGP SIGNATURE-----